11, 1, 6, 1, 7, 1, 8, 1, 12, 78, 12
11, 1, 6, 1, 7, 1, 8, 1, 68, 69, 68
11, 1, 6, 1, 7, 1, 8, 1, 0, 68, 0
2, 1, 2, 1, 2, 1, 2, 1, 1, 3, 1
0, 0, 0, 0, 0, 1, 0, 0, 0, 0, 0
2, 1, 1, 3, 1, 1, 1, 3, 1, 1, 2
9, 1, 0, 68, 12, 67, 12, 68, 0, 1, 10
9, 1, 66, 1, 1, 1, 1, 1, 66, 1, 10
9, 1, 66, 1, 23, 22, 21, 1, 66, 1, 10
1, 1, 4, 1, 11, 0, 11, 1, 4, 1, 1
14, 00, 0, 0, 0, 0, 0, 0, 0, 00, 13