20, 58, 62, 0, 0, 0, 0, 0, 0, 0, 58
20, 62, 20, 20, 20, 20, 20, 20, 20, 20, 0
20, 0, 20, 58, 0, 0, 0, 0, 0, 0, 58
20, 0, 20, 0, 20, 20, 20, 20, 20, 20, 20
20, 0, 20, 0, 20, 58, 0, 0, 0, 58, 20
20, 0, 20, 58, 0, 0, 20, 20, 20, 0, 20
20, 0, 20, 20, 20, 20, 20, 58, 0, 58, 20
20, 62, 20, 20, 20, 14, 20, 0, 20, 20, 20
20, 58, 62, 0, 70, 00, 20, 58, 0, 0, 58
20, 20, 20, 20, 20, 20, 20, 20, 20, 20, 0
13, 00, 70, 0, 0, 0, 0, 0, 0, 0, 58