19, 19, 19, 15, 15, 15, 15, 15, 19, 19, 19
19, 19, 19, 15, 191, 192, 193, 15, 19, 19, 19
19, 19, 19, 15, 194, 195, 196, 15, 19, 19, 19
19, 19, 19, 15, 197, 198, 199, 15, 19, 19, 19
19, 19, 19, 15, 15, 0, 15, 15, 19, 19, 19
19, 12, 12, 12, 12, 57, 12, 12, 12, 12, 19
19, 19, 19, 19, 19, 58, 19, 19, 19, 19, 19
19, 19, 19, 30, 58, 59, 58, 30, 19, 19, 19
19, 19, 19, 19, 19, 58, 19, 19, 19, 19, 19
19, 19, 19, 19, 12, 57, 12, 19, 19, 19, 19
19, 19, 19, 19, 19, 00, 19, 19, 19, 19, 19