# 只定义有brick的部分(屏幕上半部分), S为空, B为brick
SSSSSSSSSSSSSSSSSSSSSSSSSSSSSSSSSSSSSSSSSSSSSSSSSSSSSSSSSSSSSSSS
SSSSSSSSSSSSSSSSSSSSSSSSSSSSSSSSSSSSSSSSSSSSSSSSSSSSSSSSSSSSSSSS
SSSSSSSSSSSSSSSSSSSSSSSSSSSSSSSSSSSSSSSSSSSSSSSSSSSSSSSSSSSSSSSS
SSSSSSSSSSSSSSSSSSSSSSSSSSSSSSSSSSSSSSSSSSSSSSSSSSSSSSSSSSSSSSSS
SSSSSSSSSSBBBBBBBBBBBBBBBBBBBBBBBBBBBBBBBBBBBBBBBBBBBBSSSSSSSSSS
SSSSSSSSSSBSSSSSSSSSSSSSSSSSSSSSSSSSSSSSSSSSSSSSSSSSSBSSSSSSSSSS
SSSSSSSSSSBSBSSBSSBSSBSSBSSBSSBSSBSSBSSBSSBSSBSSBSSBSBSSSSSSSSSS
SSSSSSSSSSBSSSSSSSSSSSSSSSSSSSSSSSSSSSSSSSSSSSSSSSSSSBSSSSSSSSSS
SSSSSSSSSSBSSSBSSSSSSSSSSSSSSSSSSSSSSSSSSSSSSSSSSBSSSBSSSSSSSSSS
SSSSSSSSSSBSSSSSSSSSSSSSSSSSSSSSSSSSSSSSSSSSSSSSSSSSSBSSSSSSSSSS
SSSSSSSSSSBSSSSSBSSSSSSSSSSSSSSBBSSSSSSSSSSSSSSBSSSSSBSSSSSSSSSS
SSSSSSSSSSBSSSSSSSSSSSSSSSSSSSSSSSSSSSSSSSSSSSSSSSSSSBSSSSSSSSSS
SSSSSSSSSSBSSSSSSSBSSSSSSSSSSSSBBSSSSSSSSSSSSBSSSSSSSBSSSSSSSSSS
SSSSSSSSSSBSSSSSSSSSSSSSSSSSSSSSSSSSSSSSSSSSSSSSSSSSSBSSSSSSSSSS
SSSSSSSSSSBSSSSSSSSSBSSSSSSSSSSBBSSSSSSSSSSBSSSSSSSSSBSSSSSSSSSS
SSSSSSSSSSBSSSSSSSSSSSSSSSSSSSSSSSSSSSSSSSSSSSSSSSSSSBSSSSSSSSSS
SSSSSSSSSSBSSSSSSSSSSSBSSSSSSSSSSSSSSSSSSBSSSSSSSSSSSBSSSSSSSSSS
SSSSSSSSSSBSSSSSSSSSSSSSSSSSSSSSSSSSSSSSSSSSSSSSSSSSSBSSSSSSSSSS
SSSSSSSSSSBSSSSSSSSSSSSSBSSBSSBSSBSSBSSBSSSSSSSSSSSSSBSSSSSSSSSS
SSSSSSSSSSBSSSSSSSSSSSSSSSSSSSSSSSSSSSSSSSSSSSSSSSSSSBSSSSSSSSSS
SSSSSSSSSSBBBBBBBBBBBBBBBBBBBBBBBBBBBBBBBBBBBBBBBBBBBBSSSSSSSSSS
SSSSSSSSSSSSSSSSSSSSSSSSSSSSSSSSSSSSSSSSSSSSSSSSSSSSSSSSSSSSSSSS
SSSSSSSSSSSSSSSSSSSSSSSSSSSSSSSSSSSSSSSSSSSSSSSSSSSSSSSSSSSSSSSS
SSSSSSSSSSSSSSSSSSSSSSSSSSSSSSSSSSSSSSSSSSSSSSSSSSSSSSSSSSSSSSSS