1, 20, 20, 20, 20, 13, 20, 20, 20, 20, 1
1, 20, 20, 20, 20, 00, 20, 20, 20, 20, 1
1, 20, 20, 20, 20, 0, 20, 20, 20, 20, 1
1, 20, 20, 20, 20, 0, 20, 20, 20, 20, 1
1, 20, 20, 20, 20, 0, 20, 20, 20, 20, 1
1, 20, 20, 20, 20, 0, 20, 20, 20, 20, 1
1, 1, 20, 20, 20, 0, 20, 20, 20, 1, 1
1, 1, 1, 1, 1, 2, 1, 1, 1, 1, 1
19, 1, 19, 1, 0, 24, 0, 1, 19, 1, 19
19, 19, 19, 19, 19, hero, 19, 19, 19, 19, 19
19, 19, 19, 19, 19, 0, 19, 19, 19, 19, 19