20, 20, 20, 20, 20, 14, 20, 20, 20, 20, 20
20, 20, 20, 20, 20, 00, 20, 20, 20, 20, 20
20, 20, 20, 20, 0, 0, 24, 20, 20, 20, 20
15, 15, 15, 20, 20, 4, 20, 20, 15, 15, 15
10, 10, 15, 20, 20, 39, 20, 20, 15, 9, 9
13, 10, 58, 4, 39, 00, 39, 4, 58, 9, 302
10, 10, 15, 20, 20, 39, 20, 20, 15, 9, 9
15, 15, 15, 20, 20, 4, 20, 20, 15, 15, 15
20, 20, 20, 15, 15, 58, 15, 15, 20, 20, 20
20, 20, 20, 15, 12, 12, 12, 15, 20, 20, 20
20, 20, 20, 15, 12, 301, 12, 15, 20, 20, 20